xxxxxxxxxxxxxxxx
x             tx
xxxxxxxxxxxxxxxx
x              x
x              x
x              x
x              x
x              x
x              x
xxxxxxxxxxxxxxxx
xf            tx
xxxxxxxxxxxxxxxx